{
	"name": "A0M0",
	"width": 10,
	"length": 10,
	"spawnPosition": {
		"x": 3,
		"y": 6
	},
	"tilemap":"assets/textures/tilemap.png",
	"tileWidth":16,
	"tileHeight":16,
	"sectorTypes": [
		[2, 2, 2, 2, 0, 0, 0, 2, 2, 2],
		[2, 1, 1, 2, 0, 0, 0, 2, 1, 2],
		[2, 1, 1, 2, 2, 2, 2, 2, 1, 2],
		[2, 1, 1, 1, 1, 1, 1, 1, 1, 2],
		[2, 2, 1, 1, 1, 1, 1, 1, 1, 2],
		[0, 2, 1, 1, 1, 1, 1, 1, 1, 2],
		[0, 2, 2, 1, 1, 1, 1, 1, 1, 2],
		[0, 2, 1, 1, 1, 1, 1, 1, 1, 2],
		[0, 2, 2, 2, 2, 1, 1, 1, 1, 2],
		[0, 0, 0, 0, 2, 2, 2, 2, 2, 2]
	],
	"wallTextureIDs": [
		[0, 1, 1, 0, -1, -1, -1, 0, 0, 0],
		[0, -1, -1, 0, -1, -1, -1, 0, -1, 0],
		[0, -1, -1, 0, 0, 0, 0, 0, -1, 0],
		[0, -1, -1, -1, -1, -1, -1, -1, -1, 0],
		[0, 0, -1, -1, -1, -1, -1, -1, -1, 0],
		[-1, 0, -1, -1, -1, -1, -1, -1, -1, 0],
		[-1, 0, 0, -1, -1, -1, -1, -1, -1, 0],
		[-1, 0, -1, -1, -1, -1, -1, -1, -1, 0],
		[-1, 0, 0, 0, 0, -1, -1, -1, -1, 0],
		[-1, -1, -1, -1, 0, 0, 0, 0, 0, 0]
	],
	"floorTextureIDs": [
		[-1, -1, -1, -1, -1, -1, -1, -1, -1, -1],
		[-1, 0, 1, -1, -1, -1, -1, -1, 1, -1],
		[-1, 1, 1, -1, -1, -1, -1, -1, 1, -1],
		[-1, 1, 1, 1, 1, 1, 1, 1, 1, -1],
		[-1, -1, 1, 1, 1, 1, 1, 1, 1, -1],
		[-1, -1, 1, 1, 1, 1, 1, 1, 1, -1],
		[-1, -1, -1, 1, 1, 1, 1, 1, 1, -1],
		[-1, -1, 1, 1, 1, 1, 1, 1, 1, -1],
		[-1, -1, -1, -1, -1, 1, 1, 1, 1, -1],
		[-1, -1, -1, -1, -1, -1, -1, -1, -1, -1]
	],
	"ceilingTextureIDs": [
		[-1, -1, -1, -1, -1, -1, -1, -1, -1, -1],
		[-1, 1, 1, -1, -1, -1, -1, -1, 1, -1],
		[-1, 1, 1, -1, -1, -1, -1, -1, 1, -1],
		[-1, 1, 1, 1, 1, 1, 1, 1, 1, -1],
		[-1, -1, 1, 1, 1, 1, 1, 1, 1, -1],
		[-1, -1, 1, 1, 0, 1, 1, 1, 1, -1],
		[-1, -1, -1, 1, 1, 1, 1, 1, 1, -1],
		[-1, -1, 1, 1, 1, 1, 1, 1, 1, -1],
		[-1, -1, -1, -1, -1, 1, 1, 1, 1, -1],
		[-1, -1, -1, -1, -1, -1, -1, -1, -1, -1]
	],
	"lightColors": [
		["#000000", "#000000", "#000000", "#000000", "#000000", "#000000", "#000000", "#000000", "#000000", "#000000"],
		["#000000", "#FF6600", "#FF9933", "#000000", "#000000", "#000000", "#000000", "#000000", "#111133", "#000000"],
		["#000000", "#FF9933", "#FFCC66", "#000000", "#000000", "#000000", "#000000", "#000000", "#333366", "#000000"],
		["#000000", "#FFCC66", "#CCAA99", "#B696B6", "#9999CC", "#9999CC", "#666699", "#666699", "#333366", "#000000"],
		["#000000", "#000000", "#B696B6", "#CCCCFF", "#CCCCFF", "#CCCCFF", "#9999CC", "#666699", "#333366", "#000000"],
		["#000000", "#000000", "#9999CC", "#CCCCFF", "#FFFFFF", "#CCCCFF", "#9999CC", "#666699", "#333366", "#000000"],
		["#000000", "#000000", "#000000", "#CCCCFF", "#CCCCFF", "#CCCCFF", "#9999CC", "#666699", "#333366", "#000000"],
		["#000000", "#000000", "#666699", "#9999CC", "#9999CC", "#9999CC", "#9999CC", "#666699", "#333366", "#000000"],
		["#000000", "#000000", "#000000", "#000000", "#000000", "#666699", "#666699", "#666699", "#333366", "#000000"],
		["#000000", "#000000", "#000000", "#000000", "#000000", "#000000", "#000000", "#000000", "#000000", "#000000"]
	]
}